time_in_seconds,cars,bikes,buses,trucks,others,total
0,12,0,0,0,0,12
1,1,0,0,0,0,1
2,4,0,0,1,0,5
3,1,0,0,0,0,1
4,3,0,0,1,0,4
5,1,0,0,0,0,1
6,4,0,0,0,0,4
7,1,0,0,0,0,1
8,1,0,0,1,0,2
9,1,0,0,0,0,1
10,1,0,0,1,0,2
11,2,0,0,1,0,3
12,2,0,0,0,0,2
13,0,0,0,0,0,0
14,2,0,0,0,0,2
15,3,0,0,0,0,3
16,1,0,0,1,0,2
17,1,0,0,0,0,1
18,2,0,0,0,0,2
19,2,0,0,0,0,2
